NO ./assets/textures/tests/north.png
SO ./assets/textures/tests/south.png
WE ./assets/textures/tests/west.png
EA ./assets/textures/tests/east.png
DR

F 120,200,50
C 135,206,235

111111
100101
100O01
100W00
111111
