NO ./assets/textures/tests/north.png
SO ./assets/textures/tests/south.png
WE ./assets/textures/tests/west.png
EA ./assets/textures/tests/east.png

S2 ./assets/textures/tests/Square1.png
S2 ./assets/textures/tests/Square2.png
S2 ./assets/textures/tests/Square1.png
S2 ./assets/textures/tests/Square2.png
S2 ./assets/textures/tests/Square1.png
S2 ./assets/textures/tests/Square2.png
S2 ./assets/textures/tests/Square1.png
S2 ./assets/textures/tests/Square2.png
S2 ./assets/textures/tests/Square1.png
S2 ./assets/textures/tests/Square2.png
S2 ./assets/textures/tests/Square1.png
S2 ./assets/textures/tests/Square2.png
S2 ./assets/textures/tests/Square1.png
S2 ./assets/textures/tests/Square2.png
S2 ./assets/textures/tests/Square1.png
S2 ./assets/textures/tests/Square2.png
S2 ./assets/textures/tests/Square1.png
S2 ./assets/textures/tests/Square2.png
S2 ./assets/textures/tests/Square1.png
S2 ./assets/textures/tests/Square2.png
S2 ./assets/textures/tests/Square1.png
S2 ./assets/textures/tests/Square2.png
S2 ./assets/textures/tests/Square1.png
S2 ./assets/textures/tests/Square2.png
S2 ./assets/textures/tests/Square1.png
S2 ./assets/textures/tests/Square2.png
S2 ./assets/textures/tests/Square1.png
S2 ./assets/textures/tests/Square2.png
S2 ./assets/textures/tests/Square1.png
S2 ./assets/textures/tests/Square2.png

S3 ./assets/textures/tests/TestWall1.png
S3 ./assets/textures/tests/TestWall2.png
S3 ./assets/textures/tests/TestWall1.png
S3 ./assets/textures/tests/TestWall2.png
S3 ./assets/textures/tests/TestWall1.png
S3 ./assets/textures/tests/TestWall2.png
S3 ./assets/textures/tests/TestWall1.png
S3 ./assets/textures/tests/TestWall2.png
S3 ./assets/textures/tests/TestWall1.png
S3 ./assets/textures/tests/TestWall2.png
S3 ./assets/textures/tests/TestWall1.png
S3 ./assets/textures/tests/TestWall2.png
S3 ./assets/textures/tests/TestWall1.png
S3 ./assets/textures/tests/TestWall2.png
S3 ./assets/textures/tests/TestWall1.png
S3 ./assets/textures/tests/TestWall2.png
S3 ./assets/textures/tests/TestWall1.png
S3 ./assets/textures/tests/TestWall2.png
S3 ./assets/textures/tests/TestWall1.png
S3 ./assets/textures/tests/TestWall2.png
S3 ./assets/textures/tests/TestWall1.png
S3 ./assets/textures/tests/TestWall2.png
S3 ./assets/textures/tests/TestWall1.png
S3 ./assets/textures/tests/TestWall2.png
S3 ./assets/textures/tests/TestWall1.png
S3 ./assets/textures/tests/TestWall2.png
S3 ./assets/textures/tests/TestWall1.png
S3 ./assets/textures/tests/TestWall2.png
S3 ./assets/textures/tests/TestWall1.png
S3 ./assets/textures/tests/TestWall2.png

S4 ./assets/textures/tests/Square2.png
S4 ./assets/textures/tests/Square1.png
S4 ./assets/textures/tests/Square2.png
S4 ./assets/textures/tests/Square1.png
S4 ./assets/textures/tests/Square2.png
S4 ./assets/textures/tests/Square1.png
S4 ./assets/textures/tests/Square2.png
S4 ./assets/textures/tests/Square1.png
S4 ./assets/textures/tests/Square2.png
S4 ./assets/textures/tests/Square1.png
S4 ./assets/textures/tests/Square2.png
S4 ./assets/textures/tests/Square1.png
S4 ./assets/textures/tests/Square2.png
S4 ./assets/textures/tests/Square1.png
S4 ./assets/textures/tests/Square2.png
S4 ./assets/textures/tests/Square1.png
S4 ./assets/textures/tests/Square2.png
S4 ./assets/textures/tests/Square1.png
S4 ./assets/textures/tests/Square2.png
S4 ./assets/textures/tests/Square1.png
S4 ./assets/textures/tests/Square2.png
S4 ./assets/textures/tests/Square1.png
S4 ./assets/textures/tests/Square2.png
S4 ./assets/textures/tests/Square1.png
S4 ./assets/textures/tests/Square2.png
S4 ./assets/textures/tests/Square1.png
S4 ./assets/textures/tests/Square2.png
S4 ./assets/textures/tests/Square1.png
S4 ./assets/textures/tests/Square2.png
S4 ./assets/textures/tests/Square1.png

S5 ./assets/textures/tests/TestWall1.png
S5 ./assets/textures/tests/TestWall2.png
S5 ./assets/textures/tests/TestWall1.png
S5 ./assets/textures/tests/TestWall2.png
S5 ./assets/textures/tests/TestWall1.png
S5 ./assets/textures/tests/TestWall2.png
S5 ./assets/textures/tests/TestWall1.png
S5 ./assets/textures/tests/TestWall2.png
S5 ./assets/textures/tests/TestWall1.png
S5 ./assets/textures/tests/TestWall2.png
S5 ./assets/textures/tests/TestWall1.png
S5 ./assets/textures/tests/TestWall2.png
S5 ./assets/textures/tests/TestWall1.png
S5 ./assets/textures/tests/TestWall2.png
S5 ./assets/textures/tests/TestWall1.png
S5 ./assets/textures/tests/TestWall2.png
S5 ./assets/textures/tests/TestWall1.png
S5 ./assets/textures/tests/TestWall2.png
S5 ./assets/textures/tests/TestWall1.png
S5 ./assets/textures/tests/TestWall2.png
S5 ./assets/textures/tests/TestWall1.png
S5 ./assets/textures/tests/TestWall2.png
S5 ./assets/textures/tests/TestWall1.png
S5 ./assets/textures/tests/TestWall2.png
S5 ./assets/textures/tests/TestWall1.png
S5 ./assets/textures/tests/TestWall2.png
S5 ./assets/textures/tests/TestWall1.png
S5 ./assets/textures/tests/TestWall2.png
S5 ./assets/textures/tests/TestWall1.png
S5 ./assets/textures/tests/TestWall2.png

S6 ./assets/textures/tests/Square2.png
S6 ./assets/textures/tests/Square1.png
S6 ./assets/textures/tests/Square2.png
S6 ./assets/textures/tests/Square1.png
S6 ./assets/textures/tests/Square2.png
S6 ./assets/textures/tests/Square1.png
S6 ./assets/textures/tests/Square2.png
S6 ./assets/textures/tests/Square1.png
S6 ./assets/textures/tests/Square2.png
S6 ./assets/textures/tests/Square1.png
S6 ./assets/textures/tests/Square2.png
S6 ./assets/textures/tests/Square1.png
S6 ./assets/textures/tests/Square2.png
S6 ./assets/textures/tests/Square1.png
S6 ./assets/textures/tests/Square2.png
S6 ./assets/textures/tests/Square1.png
S6 ./assets/textures/tests/Square2.png
S6 ./assets/textures/tests/Square1.png
S6 ./assets/textures/tests/Square2.png
S6 ./assets/textures/tests/Square1.png
S6 ./assets/textures/tests/Square2.png
S6 ./assets/textures/tests/Square1.png
S6 ./assets/textures/tests/Square2.png
S6 ./assets/textures/tests/Square1.png
S6 ./assets/textures/tests/Square2.png
S6 ./assets/textures/tests/Square1.png
S6 ./assets/textures/tests/Square2.png
S6 ./assets/textures/tests/Square1.png
S6 ./assets/textures/tests/Square2.png
S6 ./assets/textures/tests/Square1.png

S7 ./assets/textures/tests/TestWall1.png
S7 ./assets/textures/tests/TestWall2.png
S7 ./assets/textures/tests/TestWall1.png
S7 ./assets/textures/tests/TestWall2.png
S7 ./assets/textures/tests/TestWall1.png
S7 ./assets/textures/tests/TestWall2.png
S7 ./assets/textures/tests/TestWall1.png
S7 ./assets/textures/tests/TestWall2.png
S7 ./assets/textures/tests/TestWall1.png
S7 ./assets/textures/tests/TestWall2.png
S7 ./assets/textures/tests/TestWall1.png
S7 ./assets/textures/tests/TestWall2.png
S7 ./assets/textures/tests/TestWall1.png
S7 ./assets/textures/tests/TestWall2.png
S7 ./assets/textures/tests/TestWall1.png
S7 ./assets/textures/tests/TestWall2.png
S7 ./assets/textures/tests/TestWall1.png
S7 ./assets/textures/tests/TestWall2.png
S7 ./assets/textures/tests/TestWall1.png
S7 ./assets/textures/tests/TestWall2.png
S7 ./assets/textures/tests/TestWall1.png
S7 ./assets/textures/tests/TestWall2.png
S7 ./assets/textures/tests/TestWall1.png
S7 ./assets/textures/tests/TestWall2.png
S7 ./assets/textures/tests/TestWall1.png
S7 ./assets/textures/tests/TestWall2.png
S7 ./assets/textures/tests/TestWall1.png
S7 ./assets/textures/tests/TestWall2.png
S7 ./assets/textures/tests/TestWall1.png
S7 ./assets/textures/tests/TestWall2.png

S8 ./assets/textures/tests/Square2.png
S8 ./assets/textures/tests/Square1.png
S8 ./assets/textures/tests/Square2.png
S8 ./assets/textures/tests/Square1.png
S8 ./assets/textures/tests/Square2.png
S8 ./assets/textures/tests/Square1.png
S8 ./assets/textures/tests/Square2.png
S8 ./assets/textures/tests/Square1.png
S8 ./assets/textures/tests/Square2.png
S8 ./assets/textures/tests/Square1.png
S8 ./assets/textures/tests/Square2.png
S8 ./assets/textures/tests/Square1.png
S8 ./assets/textures/tests/Square2.png
S8 ./assets/textures/tests/Square1.png
S8 ./assets/textures/tests/Square2.png
S8 ./assets/textures/tests/Square1.png
S8 ./assets/textures/tests/Square2.png
S8 ./assets/textures/tests/Square1.png
S8 ./assets/textures/tests/Square2.png
S8 ./assets/textures/tests/Square1.png
S8 ./assets/textures/tests/Square2.png
S8 ./assets/textures/tests/Square1.png
S8 ./assets/textures/tests/Square2.png
S8 ./assets/textures/tests/Square1.png
S8 ./assets/textures/tests/Square2.png
S8 ./assets/textures/tests/Square1.png
S8 ./assets/textures/tests/Square2.png
S8 ./assets/textures/tests/Square1.png
S8 ./assets/textures/tests/Square2.png
S8 ./assets/textures/tests/Square1.png

S9 ./assets/textures/tests/TestWall2.png
S9 ./assets/textures/tests/TestWall1.png
S9 ./assets/textures/tests/TestWall2.png
S9 ./assets/textures/tests/TestWall1.png
S9 ./assets/textures/tests/TestWall2.png
S9 ./assets/textures/tests/TestWall1.png
S9 ./assets/textures/tests/TestWall2.png
S9 ./assets/textures/tests/TestWall1.png
S9 ./assets/textures/tests/TestWall2.png
S9 ./assets/textures/tests/TestWall1.png
S9 ./assets/textures/tests/TestWall2.png
S9 ./assets/textures/tests/TestWall1.png
S9 ./assets/textures/tests/TestWall2.png
S9 ./assets/textures/tests/TestWall1.png
S9 ./assets/textures/tests/TestWall2.png
S9 ./assets/textures/tests/TestWall1.png
S9 ./assets/textures/tests/TestWall2.png
S9 ./assets/textures/tests/TestWall1.png
S9 ./assets/textures/tests/TestWall2.png
S9 ./assets/textures/tests/TestWall1.png
S9 ./assets/textures/tests/TestWall2.png
S9 ./assets/textures/tests/TestWall1.png
S9 ./assets/textures/tests/TestWall2.png
S9 ./assets/textures/tests/TestWall1.png
S9 ./assets/textures/tests/TestWall2.png
S9 ./assets/textures/tests/TestWall1.png
S9 ./assets/textures/tests/TestWall2.png
S9 ./assets/textures/tests/TestWall1.png
S9 ./assets/textures/tests/TestWall2.png
S9 ./assets/textures/tests/TestWall1.png
S9 ./assets/textures/tests/TestWall1.png

F 120,200,50
C 135,206,235

11111111111111111111111
10000000000000000000001
1000000000S000000000001
10000000000000000000001
10000000000000000000001
10002030405060708090001
10000000000000000000001
11111111111111111111111
