NO ./assets/textures/tests/north.png
WE ./assets/textures/tests/west.png
EA ./assets/textures/tests/east.png
SO ./assets/textures/tests/south.png

F 120,200,50
C 135,206,235

1111
1WE1
1111
