NO ./assets/textures/tests/north.png
WE ./assets/textures/tests/west.png
EA ./assets/textures/tests/east.png
SO ./assets/textures/tests/south.png
DR ./assets/textures/wolfestein/DoorBlue.png ./assets/textures/wolfestein/DoorBlue2.png

F 120,200,50
C 135,206,235



11111111111111111111111111111111111111111111111111
10000000000000000000000000000000000000000000000001
100S0100000000000000000000000000000000000000010011
10000000100000000000000000000000000000000000000001
10000000O00000000000000000000001P10000000000000001
10000000100000000000000000000000000000000000000001
10000000001000000000000000000000000000000000000001
10000000000000000000000000000000000000000000000001
10000000000000000000000000000000000000000000000001
10000000000000000000000000000000000000000000000001
10000000000000000000000000000000000000000000000001
10000000000000100000000100000001000000000000000001
10000000000000000000000000000000000000000000000011
10000000000000000000000000000000000000000000000001
10000000000000100000000000000001000000000000000001
10000000000000000000000000000000000000000000000001
10000000000000000000000000000000000000000000000001
10000000000000100000000100000001000000000000000001
10000000000000000000000000000000000000000000000001
10000000000000000000000000000000000000000000000001
100000000000000000000000000000000001P1000000000001
10000000000000000000000000000000000000000000000011
10000000000000000000000000000000000000000000000001
10000000000000000000000000000000000000000000000001
10000000000000000000000000000000000000000000000001
10000000000000000000000000000000000000000000000001
10000000000000000000000000000000000000000000100001
10000000000000000000000000000000000000000000000001
1000000000000000000001P100000000000000000000000001
10000000000000000000000000000000000000000000000001
10000000000000000000000000000000000000000000000001
10000000000000000000000000000000000000000000000001
100000000000000000001P1000000000000000000000000001
10000000100000000000000000000000000000000000000001
10000000000000000000000000000000000000000000000001
10000000000000000000000000000000000000000000000011
10000000000000000000000000000000000000000000000001
10000000000000000000000000000000000000000000000001
10000000000000000000000000000000000000000000000001
10000000000000000000000001P10000000000000000000001
10000000000000000000000000000000000000000000000001
10000000000000000000000000000000000000000000000001
10000000000000000000000000000000000000000000000001
10000000000000000000000000000000000000010000000011
100000000000000000000000000000000000000O0000000001
10000000000000000000000000000000000000010000000001
10000000000000000000000000000000000000000010000001
10000000000000000000000000000000000000000000000001
10001000000000000001000000000000000001000000000001
11111111111111111111111111111111111111111111111111
