NO ./assets/textures/tests/north.png
SO ./assets/textures/tests/south.png
WE ./assets/textures/tests/west.png
EA ./assets/textures/tests/east.png

F 120,200,50
C 135,206,235

11111111111111111111111
10000000000000000000001
1001010010000000111111
10000000000000W1
1000000010000000111111
10000000000000000000001
1111111111111111111111
