NO ./assets/textures/tests/north.png
SO ./assets/textures/tests/south.png
WE ./assets/textures/tests/west.png
EA ./assets/textures/tests/east.png
DR ./assets/textures/wolfestein/DoorBlue.png ./assets/textures/wolfestein/DoorBlue2.png

F 120,200,50
C 135,206,235

11111111111111111111111
10000000000000000000001
1001P100100000000000001
10000000O00000000000W01
10000000100000000000001
10000000000000000000001
11111111111111111111111
