NO ./assets/textures/tests/north.png
WE ./assets/textures/tests/west.png
EA ./assets/textures/tests/east.png
SO ./assets/textures/tests/south.png

F 120,200,50
C 135,206,235

1111111111111111111111111111111
1000000000000000000000000000001
1000000000000000000000000000001
1000000000000000000000000000001
1000000000000000000000000000001
1000000000000000000000000000001
1000000000000000010000000000001
1000000001000000000001000000001
1000000000000S00000000000000001
1000000000000000000000000000001
1000000000000011000000000000001
1000000000000000000000000000001
1000000100000000000000000000001
1000000000000000000000000000001
1111111111111111111111111111111
