NO ./textures/boat.png
SO ./textures/boat.png
WE ./textures/boat.png
EA ./textures/boat.png

F 200, 200, 200
C 0, 0, 0

 
 
11S11
10001
10001
10001
11111
 
 
 11111111
 10000001
 11111111
 
 
 1111111111111111111111111
 1000000011111111111111111
 1111111111111000000000111
 1111111111111111111111111
 1111111111111111111111111
 
 11111
 10001
 10001
 10001
 11111
 
 