NO ./textures/boat.png
SO ./textures/boat.png
WE ./textures/boat.png
EA ./textures/boat.png

F 200, 200, 200
C 0, 0, 0

 
 
11111
10001
10001
10001
11111
 
 
 11111111
 10000001
 11111111
 
 
 1111111111111111111111111
 10000W0011111111111111111
 1111111111111000W00000111
 1111111111111111111111111
 1111111111111111111111111
 
 11111
 10001
 10001
 10001
 11111
 
 