NO ./textures/boat.png
SO ./textures/boat.png
WE ./textures/boat.png
EA ./textures/boat.png
F 200, 200, 200
C 0, 0, 0
11111
10001
1WE01
10001
11111
