NO ./textures/bluestone.png
SO ./textures/greystone.png
WE ./textures/redbrick.png
EA ./textures/wood.png
DR ./textures/DoorBlue.png ./textures/DoorBlue2.png
S2 ./textures/s2f1.png
S2 ./textures/s2f30.png
S2 ./textures/s2f3.png
S2 ./textures/s2f4.png
S2 ./textures/s2f5.png
S2 ./textures/s2f6.png
S2 ./textures/s2f7.png
S2 ./textures/s2f8.png
S2 ./textures/s2f9.png
S2 ./textures/s2f10.png
S2 ./textures/s2f11.png
S2 ./textures/s2f12.png
S2 ./textures/s2f13.png
S2 ./textures/s2f14.png
S2 ./textures/s2f15.png
S2 ./textures/s2f16.png
S2 ./textures/s2f17.png
S2 ./textures/s2f18.png
S2 ./textures/s2f19.png
S2 ./textures/s2f20.png
S2 ./textures/s2f21.png
S2 ./textures/s2f22.png
S2 ./textures/s2f23.png
S2 ./textures/s2f24.png
S2 ./textures/s2f25.png
S2 ./textures/s2f26.png
S2 ./textures/s2f27.png
S2 ./textures/s2f28.png
S2 ./textures/s2f29.png
S2 ./textures/s2f30.png
S3 ./textures/TestWall1.png
S3 ./textures/TestWall2.png
S9 ./textures/Square1.png
S9 ./textures/Square2.png
S9 ./textures/Square3.png
S9 ./textures/Square4.png
S9 ./textures/Square5.png

F 120,200,50
C 135,206,235

11111111111111111111111111111111111
12000000000000000000000000000000001
10E000000000000000101001P1000000001
10000002300001P10000000000000000001
100000032000011100101001P1000000001
10000000000001110000000000000000001
10111101000001P100101001P1000000001
10O11O0O0000000000101001P1000000001
10111101000001P100101001P1000000001
10000000000000000000000000000000001
11111111111111111111111111111111111
