NO ./textures/bluestone.png
SO ./textures/greystone.png
WE ./textures/redbrick.png
EA ./textures/wood.png
DR ./textures/DoorBlue.png ./textures/DoorBlue2.png

F 120,200,50
C 135,206,235

111111111111111111111
100000000000000000001
10S000000000000000101
100000000000000000O01
100000000000000000101
100000000000000000001
100000000000000000001
100000000000000000001
1000000000000001P1001
100000000000000000001
111111111111111111111
