NO ./textures/boat.png
SO ./textures/boat.png
WE ./textures/boat.png
EA ./textures/boat.png
F 200, 200, 200
C 0, 0, 0


 
1
 
11111
10001
1W001
10001
11111
 
1
 