NO ./textures/42.png
SO ./textures/42.png
WE ./textures/42.png
EA ./textures/42.png
DR ./textures/DoorBlue.png ./textures/DoorBlue2.png

F 120,200,50
C 135,206,235

11111111111111111111111111111111111
10000000000000000000000000000000001
10E000000000000000101001P1000000001
10000000000001P10000000000000000001
100000000000011100101001P1000000001
10000000000001110000000000000000001
10111101000001P100101001P1000000001
10O11O0O0000000000101001P1000000001
10111101000001P100101001P1000000001
10000000000000000000000000000000001
11111111111111111111111111111111111
