NO ./textures/bluestone.png
SO ./textures/greystone.png
WE ./textures/redbrick.png
EA ./textures/wood.png

F 0,0,0
C 0,0,0

111111111111111111111
100000000000000000001
1000000000S0000000001
100000000000000000001
100000000000000000001
100000100001000000001
100000000010000000001
100000000000000000001
100000000000000000001
100000000000000000001
111111111111111111111
